aaron|e r 1 n
abad|aa b aa t
abbasi|a b b a s ii
abc|e j b i s i
abdulaziz|a b d u 5 1 z i z
abdullah|a b d u 5 5 a h
abee|a b e e
abe|a b e
abi|aa b i
abraham|e j b r 1 h e m
academy|e c e d 1 m i
acta|a k t a
acton|e k t 1 n
actors|e k t 1 r s
actor|e k t 1 r
acuna|a k u n a
adamina|a d a m i n a
adami|a d aa m i
adams|e d 1 m s
adar|a d a r
adas|e j d 1 s
adele|a d e l
adenauer|e j d i n a w 1 r
adeta|aa d e t a
adidas|a d i d 1 s
adina|a d i n a
adin|a d i n
adler|e d 5 1 r
admin|e d m i n
adnan|e d n 1 n
adorno|a d o r n o
adriana|e j d r i e n a
adriano|a d r i a n o
adrian|a d r i a n
advanced|e d v e n s t
adventure|e d v e n tS 1 r
after|e f t 1 r
against|e gj e j n s t
again|e gj e n
agatha|a g a t a
aglaya|a g 5 a j a
agree|e g r i
aguilera|a gj i l e r a
ahah|a h a h
ahh|a h
ahmed|a h m e t
ailene|a j l e n
airbus|e j 1 r b a s
airlines|e r 5 a j n z
air|e j 1 r
aitken|a j t c e n
ajar|e dZ a r
ajax|e j dZ e k s
aker|e k 1 r
akin|a c i n
akp|aa c ee p ee
alain|e 5 e j n
alakam|a 5 a k a m
alam|a 5 a m
alana|a 5 a n a
alarma|a 5 a r m a
alarm|a 5 a r m
alaska|e 5 e s k 1
alben|e 5 b 1 n
alberto|a 5 b e r t o
albert|a 5 b e r t
albino|e 5 b a j n o
album|e 5 b 1 m
alcan|a 5 k a n
alda|a l d a
aldin|a 5 d i n
aldi|a 5 d i
aldous|o 5 d 1 s
alejandro|a l e h a n d r o
aleksandr|a l e k s a n d 1 r
ales|a l e s
alexander|a l e k s a n d 1 r
alexandre|a l i k s a n d 1 r
alexis|a 5 e k s i s
alexi|e 5 e k s i
alex|e 5 1 k s
aley|e l e j
alfred|a l f r e t
alibaba|a l i b a b a
alice|e l 1 s
alihan|a l i h a n
alija|e 5 a j dZ a
allahım|a 5 5 aa h 1 m
allan|e 5 1 n
alla|a 5 a
allen|e l 1 n
allianz|e l i 1 n z
allie|e l i
all|o 5
almeida|a l m e i d a
along|e 5 o N k
alonso|e 5 o n s o
alper|e 5 p 1 r
alpha|e 5 f a
alphonse|e 5 f o n s
altima|a 5 t i m a
alvaro|a 5 v a r o
alves|a l v 1 s
always|o 5 w e j s
alzheimer|a 5 z a j m 1 r
amanda|a m e n d a
amann|a m a n
amcan|a m k a n
amen|a m e n
american|a m e r i k 1 n
america|e m e r 1 k 1
amino|a m i n o
ami|a m i
amman|a m a n
amok|a m o k
amon|a m o n
amsterdam|e m s t 1 r d e m
amy|e j m i
anatole|e n 1 t o u 5
anaya|a n a j a
andersen|e n d 1 r s 1 n
anderson|e n d 1 r s 1 n
ander|a n d e r
andreas|a n d r e a s
andrea|e n d r i a
andrei|a n d r e j
andres|a n d r e z
andrew|e n d r y
andrey|a n d r e j
andre|a n d r e
android|a n d r o i t
andy|e n d i
and|e n t
angela|e n dZ 1 5 a
angeles|e n dZ 1 l i s
angelou|e n dZ 1 5 u
angels|e j n dZ 1 5 z
angel|e j n dZ 1 5
aniden|aa n i d e n
anime|a n i m e
ani|aa n ii
anna|a n n a
anneli|a n n e l i
annem|a n n e m
annen|e n 1 n
annie|e n i
announce|e n a u n s
ann|e n
another|e n a d 1 r
antarktika|a n t a r k t i k a
ante|e n t i
anthony|e n t 1 n i
antic|e n t i k
anti|e n t i
antonio|a n t o n i o
anton|a n t o n
api|e j p i a j
apple|e p 1 5
app|e p
ap|aa p ee
arab|e r 1 p
aragon|e r 1 g o n
araki|a r a c i
aral|a r a 5
arana|a r a n a
aranda|a r e n d a
aran|a r a n
ararat|a r a r a t
architects|a r c i t e k t s
ard|a r t
arendt|a r e n t
ares|a r e s
are|a r
ariel|e r i 1 5
aristoteles|a r i s t o t e l e s
aristo|a r i s t o
arizona|a r i z o n a
arko|a r k o u
arman|a r m a n
armstrong|a r m s t r 1 N k
army|a r m i
arnold|a r n 1 l t
aron|e r 1 n
aro|a r o
arrest|a r e s t
arsenal|a r s e n a 5
arthur|a r t u r
artman|a r t m 1 n
artvin|a r t v i n
asaf|a s a f
asimov|a s i m o w
askin|a s c i n
asp|e s p
assam|a s a m
ass|e s
aston|e s t 1 n
astral|e s t r 1 5
asus|e j s 1 s
ataturk|a t a t y r k
ates|e j t s
athena|a t i n a
athletic|e t 5 e t i c
atkinson|e t c i n s 1 n
atlanta|e t 5 e n t a
atletico|a t l e t i k o
atman|e t m 1 n
atm|aa t ee m ee
atta|a t t a
attila|a t i 5 a
attitude|e t 1 t j u t
atv|aa t ee v ee
atwood|e t w u t
audi|o d i
audrey|o d r i
august|a g 1 s t
aurelio|a u r e j l i o
aurelius|o r e l i u s
austen|o s t i n
auster|o s t 1 r
austin|o s t i n
avatar|a v a t a r
avent|a v a n
avis|e j v i s
aviv|a v i v
avi|a v i
avm|aa v ee m ee
avon|e j v 1 n
avucunu|a w u dZ u n u
axel|e k s 1 5
aydin|a j d i n
ayr|e j 1 r
azeri|a z e r i
aşağıya|a S aa 1 j a
aşka|a S k a
baa|b i e j e j
babel|b e b 1 5
babe|b e j p
babies|b e j b i s
babylon|b e b i 5 1 n
baby|b e j b i
bab|b e p
bach|b a h
bacon|b e j k 1 n
badu|b 1 d u
bae|b a j
bafetimbi|b a f e t i m b i
bag|b e k
bahr|b a r
bah|b a h
bailey|b e j l i
baker|b e j k 1 r
balance|b e 5 1 n s
balboa|b a 5 b o a
balik|b a l i k
bali|b a l i
ballon|b a l o n
ball|b o 5
baltazar|b a 5 t a z a r
balzac|b a 5 z a k
banana|b a n e n a
bandana|b e n d e n a
banderas|b e n d e r 1 s
band|b e n t
bang|b e N k
banu|b aa n u
barack|b a r 1 k
bara|b a r a
barbara|b a r b a r a
barbie|b a r b i
barbosa|b a r b o u s 1
barbra|b a r b 1 r a
barca|b a r k a
barcelona|b a r s e 5 o n a
bare|b e r
baris|b a r i s
baroni|b a r o n i
basayev|b a s a j e v
basel|b a z 1 5
basim|b a s i m
basin|b e j s 1 n
basi|b a s i
baskette|b 1 s c e t
basra|b a s r a
bassam|b a s a m
bassin|b a s e n
bass|b e j s
basta|b a s t a
bastin|b e s t i n
batan|b a t a n
battle|b e t 1 5
bauman|b a u m 1 n
bax|b e k s
bayar|b a j a r
bayern|b a j e r n
bazan|b a z a n
bbc|b i b i s ii
bear|b e r
beat|b i t
beautiful|b j u t i f u 5
beauty|b j u t i
bea|b i
bebee|b i b i
beckett|b e c i t
beckham|b e k h e m
beck|b e c
bed|b e t
been|b i n
beer|b i r
beethoven|b e j t o u v 1 n
bee|b i
before|b i f o r
begin|b i gj i n
bein|b i n
beji|b e Z i
belarus|b e 5 a r u s
bela|b e 5 1
belden|b e 5 d 1 n
belin|b e l i n
bella|b e 5 a
bell|b e 5
bem|b e m
bena|b e n a
benda|b e n d a
bender|b e n d 1 r
bend|b e n t
bene|b e n e
benin|b e n i n
benjamin|b e n dZ 1 m 1 n
benn|b e n
bensen|b e n s 1 n
benítez|b e n i t 1 z
beraberlikti|b e r aa b e r l i c t i
bergama|b e r g a m a
bergen|b 2 r g 1 n
berger|b 2 r g 1 r
bergman|b 2 r g m 1 n
berkes|b 2 r k s
berke|b 2 r k
berlin|b e r l i n
berman|b e r m 1 n
bernard|b e r n 1 r t
berna|b e r n a
bernd|b 2 r n t
bero|b e r o
bertrand|b 2 r t r 1 n t
besler|b e s l e r
best|b e s t
bes|b e s
better|b e t 1 r
beyonce|b i j o n s e j
beyond|b i j o n t
biden|b a j d 1 n
bieber|b i b 1 r
bienvenu|b j a n v e n y
big|b i k
bike|b a j k
bilardo|b i l aa r d o
bild|b i 5 t
billboards|b i 5 b o r t s
billboard|b i 5 b o r t
billy|b i l i
bill|b i 5
bil|b i l
bimbo|b i m b o
binanın|b i n aa n 1 n
bio|b a j o
bipolar|b i p o 5 a r
bip|b i p
birle|b 2 r 5
birr|b 2 r
birthday|b 2 r t d e j
bise|b i s
bis|b i s
bitcoin|b i t k o j n
bite|b a j t
bjk|b ee Z ee c ee
blackboard|b l e k b o r t
black|b 5 e k
blaise|b 5 e j z
blake|b l e j k
blanc|b 5 e N k
blinders|b l a j n d 1 r s
blockchain|b l o k tS e j n
block|b l o k
blog|b l o k
bloklar|b 5 o k 5 a r
blood|b 5 a t
bloomberg|b u l u m b e r k
blow|b 5 o w
blues|b 5 u s
bluetooth|b l y t u t
blue|b l u
bmw|b i e m d a b 1 l j u
bobby|b a b i
bobo|b o w b o w
bob|b o p
boeing|b o u i N k
bogdan|b o g d a n
bohemian|b o u h i m i 1 n
bold|b o w 5 t
bole|b o w 5
boll|b o 5
bologna|b o 5 o n j a
bolton|b o 5 t 1 n
bolt|b o u 5 t
bonaparte|b o n a p a r t
bond|b o n t
boni|b o n i
bonjour|b o n Z u r
bonomo|b a n 1 m o w
bonus|b o n 1 s
bony|b o u n i
book|b u k
boral|b o r 1 5
bordeaux|b o r d o u
borges|b o r h e s
boris|b o r i s
born|b o r n
borussia|b o r u s j a
bosch|b o S
bosna|b o s n a
boss|b a s
boston|b o s t 1 n
boxer|b o k s 1 r
boyan|b o j 1 n
boyd|b o j t
boyko|b o j k o
boyle|b o j 5
boys|b o j z
boyum|b o j u m
boztepe|b o s t e p e
bo|b o w
bradbury|b r e d b e r i
brader|b r e d 1 r
bradley|b r e d l i
brad|b r e t
braga|b r a g a
braille|b r a j
bram|b r e m
brasco|b r e s k o
brat|b r e t
braz|b r e z
bra|b r a
breaking|b r e j c i N c
break|b r e j c
brecht|b r e h t
bremen|b r e m 1 n
briana|b r i e n 1
brian|b r a j 1 n
brigitte|b r i dZ i t
brine|b r a j n
britanya|b r i t a n j a
british|b r i t i S
bromm|b r a m
brooklyn|b r u k l i n
brooks|b r u k s
brother|b r a d 1 r
brown|b r a u n
browser|b r a u z e r
bro|b r o
bruce|b r y s
bruno|b r u n o
brunson|b r a n s 1 n
bryant|b r a j 1 n t
buenos|b u e n o s
buffalo|b a f 1 5 o
buffet|b a f 1 t
buga|b j u g 1
bug|b a k
bukowski|b u k o v s c i
bulent|b y l e n t
bullet|b u 5 1 t
bullseye|b u 5 z a j
bull|b u 5
bulman|b u 5 m 1 n
bum|b a m
bundesliga|b u n d e s l i g a
bungee|b a n dZ i
burada|b u r d a
burak|b u r a k
burda|b u r d a
burger|b 2 r g 1 r
burkina|b 2 r c i n a
burnley|b 2 r n l i
burns|b 2 r n z
burroughs|b a r o u z
bur|b 2 r
buscaglia|b u s k a g l i a
business|b i z n 1 s
butler|b a t 5 1 r
buza|b u z a
bye|b a j
byron|b a j r 1 n
caan|c e n
caceres|k a s e r e s
cad|c e t
cafer|dZ aa f ee r
cafe|k a f e j
cagliari|k a l j a r i
cahide|dZ aa h i d e
caicedo|k a tS e j d o
calan|k a 5 a n
caleb|c e j l e p
california|c e l i f o r n i j a
call|k o 5
cal|c e 5
cama|k a m a
cambridge|c e m b r i tS
campos|k a m p o s
camp|c e m p
camus|c e m u s
cancan|c e n c e n
candy|c e n d i
canetti|k a n e t i
cane|c e j n
canin|c e j n i n
cann|c e n
cano|k a n o
cao|k a o
capital|c e p 1 t 1 5
capon|c e j p 1 n
cappy|c e p i
caps|c e p s
cap|c e p
cardiff|k a r d i f
cardozo|k a r d o s o
card|k a r t
care|c e r
cargill|k a r gj i 5
carles|k a r 5 s
carlos|k a r 5 o s
carl|k a r 5
carnegie|k a r n 1 gj i
carole|c e r 1 5
carrey|c e r i
carrier|c e r i 1 r
carroll|c e r 1 5
cartel|k a r t e 5
carte|k a r t
carvalho|k a r v a l j u
casablanca|c e s 1 b 5 e N k a
casanova|c a s a n o v a
casa|k a s a
cash|c e S
casillas|k e s i 5 1 s
casper|k a s p 1 r
castillo|k a s t i l j o
castro|c e s t r o w
cas|c e s
cat|c e t
cay|c e j
cece|s i s
cede|s i t
cedric|s e d r i c
celladın|dZ e l l a d 1 n
celtics|s e 5 t i k s
celtic|s e 5 t i k
center|s e n t 1 r
ceo|s i i o u
cervantes|s 1 r v a n t 1 s
cervi|tS e r v i
cesare|tS e z a r e
cesar|s e z a r
ceyn|dZ e j n
chadli|tS e d l i
challenge|tS e l 1 n tS
championship|tS e m p i 1 n S i p
champion|tS e m p i 1 n
chanel|S 1 n e 5
channel|tS e n 1 5
channing|tS e n i N c
chan|tS e n
chaplin|tS e p l i n
charles|tS a r 1 5 s
charlie|tS a r l i
char|tS a r
chatham|tS e t 1 m
chaves|tS a v e s
check-up|tS e k a p
checkup|tS e k a p
cheers|tS i r s
chelsea|tS e 5 s i
chen|tS e n
cherbourg|S e r b u r k
chery|tS e r i
chesterton|tS e s t 1 r t 1 n
che|tS e
chicago|S 1 k a g o u
chico|tS i k o
chomsky|tS o m s c i
chopin|S o p e n
chp|dZ ee h ee p ee
christian|k r i s tS 1 n
christie|k r i s t i
christina|k r i s t i n a
christmas|k r i s m 1 s
christopher|k r i s t 1 f 1 r
christophe|k r i s t o f
chris|k r i s
chuck|tS a k
churchill|tS 2 r tS i l
cia|s i a j e j
cia|s i a j e j
cicero|s i s 1 r o w
cinema|s i n e m a
cio|s i a j o u
cirkin|s 2 r c i n
citroen|s i t r o e n
city|s i t i
cit|s i a j t i
cizik|s i z i c
clark|k 5 a r k
claro|k l a r o
class|k 5 e s
claude|k 5 o t
cleveland|k l i v 5 1 n t
clickbait|k l i k b e j t
closer|k l o w s 1 r
cloud|k 5 a u t
club|k 5 a p
cnn|s i e n e n
cobain|k o u b e j n
coca-cola|k o k a k o l a
coca|k o k a
coco|k o u k o u
coelho|k o e 5 h o
cohen|k o w 1 n
coin|k o j n
cola|k o 5 a
colin|k o l i n
colman|k o w 5 m 1 n
combo|k o m b o
come|k a m
comic|k o m i c
coming|k a m i N k
comment|k a m 1 n t
company|k o m p 1 n i
comprehensive|k a m p r i h e n s i v
com|k o m
conant|k o u n 1 n t
conan|k o n 1 n
condom|k a n d 1 m
congratulations|k 1 n g r e tS 1 5 e j S 1 n z
constant|k a n s t 1 n t
conte|k o n t e
contra|k a n t r 1
converse|k a n v 2 r s
con|k a n
cook|k u k
coolman|k u 5 m 1 n
cool|k u 5
cooper|k u p 1 r
copa|k o p a
cope|k o u p
copy|k a p i
corrie|k o r i
costa|k o s t a
council|k a u n s 1 5
couple|k a p 1 5
course|k o r s
courtois|k u r t w a
coventry|k a v 1 n t r i
cover|k a v 1 r
cox|k o k s
craig|k r e j c
creatures|k r i tS 1 r s
cringe|k r i n tS
cristiano|k r i s t i a n o
cristian|k r i s t i a n
cristina|k r i s t i n a
crush|k r a S
crystal|k r i s t 1 5
cry|k r a j
cum|k a m
curry|k a r i
cute|c j u t
cv|s i v i
d'or|d o r
dad|d e t
dag|d e k
daily|d e j l i
dakikanın|d a c ii k a n 1 n
dakikaya|d a c i k a j a
dak|d e c
dale|d e j 5
dali|d a l i
dallara|d e 5 a r 1
dallas|d e 5 1 s
dalton|d o 5 t 1 n
dame|d e j m
damien|d e m j 1 n
damme|d e m
damn|d e m
dance|d e n s
daner|d a n e r
daniel|d e n i j 1 5
daniyar|d aa n j a r
dani|d a n i
dante|d a n t e
dany|d e n i
darkest|d a r k 1 s t
dark|d a r k
darwin|d a r v i n
data|d e j t 1
daum|d a u m
david|d e j v i t
davis|d e j v 1 s
davranan|d a v r a n a n
davud|d a v u t
dayan|d e j 1 n
daya|d a j 1
day|d e j
dc|d i s i
deel|d i 5
deep|d i p
dee|d i
degas|d e g 1 s
degrasse|d i g r a s
delhi|d e l i
deline|d e l i n e
del|d e l
demirel|d e m i r e l
demi|d e m i
demler|d e m l e r
democracy|d i m o k r 1 s i
demoralize|d i m o r 1 5 a j s
demo|d e m o u
denayer|d e n a j e r
denis|d e n i s
dennis|d e n i s
dense|d e n s
dens|d e n s
denver|d e n v 1 r
deodorant|d i o u d 1 r 1 n t
deo|d i o
derailed|d i r e j 5 t
derek|d e r i k
deride|d i r a j t
derik|d e r i k
dermis|d 2 r m i s
dest|d e s t
detected|d i t e k t 1 t
detroit|d e t r o j t
dexter|d e k s t 1 r
dey|d e j
değer|d ee e r
diablo|d i a b 5 o
diagne|d i a g n e
diaries|d a j 1 r i s
dia|d i a
dick|d i c
didier|d i d j e r
didi|d i d i
diego|d i j e g o
die|d a j
die|d i
digital|d i dZ i t 1 5
dille|d i l
dime|d a j m
dim|d i m
dino|d i n o w
dion|d a j 1 n
dirk|d 2 r k
dislike|d i s 5 a j k
disney|d i z n i
dispatch|d i s p e tS
disraeli|d i z r e j l i
diss|d i s
dis|d i s
dixon|d i k s 1 n
dj|d i dZ e j
dk|d i c e j
dm|d i e m
dna|d i e n e j
doctor|d a k t 1 r
documents|d o c j u m 1 n t s
dogan|d o a n
dollar|d a 5 1 r
dol|d o 5
domenico|d o m e n i k o
domine|d o m i n e
dominic|d o m i n i c
dom|d o m
donald|d a n 1 5 t
donar|d o n a r
donat|d o n 1 t
doner|d o n e r
donnie|d a n i
donovan|d a n 1 v 1 n
doom|d u m
doritos|d o r i t o u s
dortmund|d o r t m u n t
dort|d o r t
dostoyevski|d o s t o j e v s c i
double|d a b 1 5
douglas|d a g 5 1 s
dove|d a v
down|d a u n
dramını|d r a m 1 n 1
dream|d r i m
drina|d r i n a
drink|d r i N c
drogba|d r o g b a
drone|d r o w n
drop|d r o p
dryden|d r a j d 1 n
dr|d r a j v
dsi|d e s e i
dubai|d u b a j
dublin|d a b l i n
dumas|d y m a
dunkirk|d a n k 1 r k
durant|d y r a n t
dura|d u r a
dvd|d i v i d i
dwyer|d w a j 1 r
dynamo|d a j n 1 m o
e-mail|i m e j 5
eagle|i g 1 5
earth|2 r t
ebbing|e b i N c
eben|e b 1 n
ebola|e b o 5 a
ecevit|e dZ e v i t
eco|e k o
edam|i d 1 m
eden|e d 1 n
edgar|e d g 1 r
edin|e d i n
edirne|e d i r n e
edison|e d i s 1 n
edition|e d i S 1 n
edit|e d i t
eduardo|e d w a r d o u
edward|e d w 1 r t
edwin|e d w i n
ed|e t
eeg|i c
ee|i
effect|e f e k t
efim|e f i m
egon|i g 1 n
ehle|i 5 1
eindhoven|a j n d h o v 1 n
einstein|a j n S t a j n
ekg|ee c ee gj ee
ela|e 5 a
elbert|e 5 b 1 r t
eleanor|e 5 1 n 1 r
elene|e l i n
elf|e l f
elias|e l a j a s
elia|i 5 a j a
eliot|e l i o t
elisabeth|i l i z 1 b i t
elite|i l i t
elizabeth|e l i z 1 b 1 t
elvis|e 5 v i s
emerson|e m 1 r s 1 n
emery|e m 1 r i
emile|e m i l
emily|e m i l i
emil|e m i 5
eminem|e m i n 1 m
eminim|e m ii n i m
emirates|e m 1 r 1 t s
emmanuel|i m e n j u 1 5
emma|e m a
endeavor|i n d e v 1 r
endgame|e n d gj e j m
end|e n t
engine|e n dZ i n
english|i N g l i S
enis|e n i s
enter|e n t 1 r
ente|e n t e
entry|e n t r i
enzo|e n z o w
epiphany|e p i f 1 n i
eralp|e r 1 5 p
erasmus|e r a s m u s
erbakan|e r b a k a n
erich|e r i h
eric|e r i c
erler|e r l e r
erman|e r m 1 n
ernesto|e r n e s t o
ernest|2 r n 1 s t
ernst|e r n s t
erol|e r 1 5
error|e r 1 r
erwin|e r v i n
erzurum|e r z u r u m
escobar|e s k o b a r
esprisi|e s p i r i s i
esse|e s e
esteban|e s t e b a n
est|e s t
etienne|e t j e n
etrafını|e t r aa f 1 n 1
etti|e t t i
eurasia|j u r e j Z a
euroluk|j u r o 5 u k
euro|j u r o u
evanescence|e v a n e s 1 n s
event|i v e n t
everton|e v 1 r t 1 n
ever|e v 1 r
evett|e v e t
eve|i v
evladım|e v l aa d 1 m
evlat|e v l a t
exchange|i k s tS e j n tS
explorer|i k s p l o r 1 r
express|i k s p r e s
extraordinary|e k s t r a o r d i n 1 r i
extra|e k s t r a
eyeliner|a j l a j n 1 r
eyes|a j s
eye|a j
eyler|e j 5 1 r
ezer|e z e r
eğer|ee e r
faber|f e b 1 r
fabiano|f a b i a n o
fabian|f e j b i a n
fabri|f e b r i
facebook|f e j s b u k
face|f e j s
facts|f e k t s
fahrenheit|f e r i n h a j t
fake|f e j k
false|f o 5 s
fame|f e j m
farah|f e r a
faso|f a s o
faure|f o r
favourite|f e j v 1 r i t
fax|f e k s
fbi|e f b i a j
feat|f i t
fedakar|f e d aa c a r
federer|f e d 1 r 1 r
federici|f e d e r i tS i
federico|f 1 d 1 r i k o u
fed|f e t
feels|f i 5 s
felan|f e 5 1 n
felipe|f i l i p
felix|f i l i k s
felt|f e 5 t
fenelon|f e n i 5 1 n
ferdinand|f 2 r d i n e n t
ferguson|f e r g u s o n
fernandes|f e r n a n d 1 s
fernando|f e r n a n d o
fero|f e r o
ferrari|f e r a r i
fetö|f e t 2
fiat|f i 1 t
fiction|f i k S 1 n
fidel|f i d e l
fifa|f i f a
fifi|f i f i
fighting|f a j t i N c
fight|f a j t
fiji|f i dZ i
filarmoni|f i 5 a r m o n i
filipovic|f i l i p o v i tS
filip|f i l i p
filler|f i 5 1 r
financial|f a j n e n S 1 5
finlandiya|f i n 5 a n d i j a
finley|f i n l i
first|f 2 r s t
fishing|f i S i N c
fish|f i S
fitch|f i tS
fitness|f i t n 1 s
five|f a j v
flanders|f 5 e n d 1 r s
flap|f 5 e p
flash|f 5 e S
flaubert|f 5 o b e r
flim|f l i m
flood|f 5 a t
flop|f l a p
florence|f 5 o r 1 n s
flower|f 5 a u 1 r
flow|f l o w
floyd|f 5 o j t
flu|f l y
flynn|f l i n
fm|e f e m
follow|f o l o w
fontaine|f o n t e n
fools|f u 5 s
football|f u t b o 5
forbes|f o r b z
ford|f o r t
forest|f o r 1 s t
forever|f o r e v 1 r
forklift|f o r k l i f t
forman|f o r m 1 n
formula|f o r m j u 5 a
forrest|f o r 1 s t
forza|f o r z a
for|f o r
foster|f o s t 1 r
foucault|f u k o
fox|f o k s
francesco|f r e n tS e s k o u
france|f r e n s
francisco|f r e n s i s k o
francis|f r e n s 1 s
franck|f r e N c
franco|f r a N k o
frankenstein|f r e N k 1 n s t a j n
frankfurt|f r e N k f 1 r t
franklin|f r e N k l i n
frankl|f r e N k 1 5
franz|f r a n s
freddie|f r e d i
frederick|f r e d e r i c
fredy|f r e d i
fred|f r e t
freeman|f r i m 1 n
freestyle|f r i s t a j 1 5
free|f r i
frei|f r e j
freud|f r o j t
frey|f r e j
friday|f r a j d i
frida|f r i d a
friedrich|f r i d r i h
friendly|f r e n t l i
friends|f r e n t s
friend|f r e n t
fringe|f r i n tS
fromm|f r o m
from|f r a m
frost|f r o s t
frozen|f r o u z 1 n
fulbright|f u 5 b r a j t
fyodor|f j o d 1 r
gabon|g a b o n
gabor|g 1 b o r
gabriel|gj e j b r i 1 5
gadget|gj e dZ 1 t
gael|gj e j 5
galan|gj e 5 1 n
galaxy|gj e 5 1 k s i
galeano|g a l e a n o
galileo|gj e l i l e o
galler|g o 5 1 r
games|gj e j m z
game|gj e j m
gandalf|gj e n d 1 5 f
gandhi|g a n d i
ganimeti|g a n ii m e t i
gap|gj e p
garage|g 1 r a S
gara|g a r a
garcia|g a r s i a
garda|g a r d 1
gareth|gj e r 1 t
garfield|g a r f i 5 t
gari|g a r i
garry|gj e r i
gary|gj e r i
gaston|gj e s t 1 n
gates|gj e j t s
gattuso|g a t u s o
gazali|g a z a l i
gell|dZ e 5
genco|dZ e N k o w
genk|dZ e N k
geographic|dZ i 1 g r e f i c
georges|dZ o r dZ 1 s
george|dZ o r t S
georgia|dZ o r dZ i a
gerard|dZ 1 r a r t
gerda|gj 2 r d a
germain|dZ i r m e j n
german|dZ 2 r m 1 n
gerritsen|gj e r i t s 1 n
get|gj e t
ghosts|g o u s t s
gianni|dZ i a n i
gib|gj i p
gigi|Z i Z i
gignac|Z i n j a c
gilbert|gj i 5 b 1 r t
gillette|dZ i l e t
gill|gj i 5
gina|dZ i n a
giordano|dZ o r d a n o u
giovanni|dZ o v a n n i
giremez|gj i r e m e z
girlfriends|gj 2 r 5 f r e n t s
girls|gj 2 r 5 s
girl|gj 2 r 5
giuliano|dZ u l i a n o
gladyatör|g 5 a d j a t 2 r
glasgow|g 5 e s g o u
gluten|g l y t 1 n
gmail|dZ i m e j 5
gm|dZ i e m
goat|g o u t
godard|g o d a r
godfather|g a t f a d 1 r
godin|g o u d 1 n
godiva|g a d a j v a
godless|g a d 5 1 s
god|g a t
goebbels|g e b e l s
goes|g o u s
goethe|gj 2 t e
gogh|g o w
going|g o w i N k
golan|g o l a n
golay|g o 5 e j
golden|g o l d 1 n
golde|g o 5 d e
golding|g o u 5 d i N k
goldman|g o u 5 d m 1 n
gold|g o w 5 t
goley|g o l e j
goller|g o 5 1 r
golle|g a 5
goll|g o 5
gomez|g o m e z
gonder|g a n d 1 r
gonya|g o n j a
goodbye|g u d b a j
goodmorning|g u d m o r n i N c
good|g u t
google|g u g 1 5
gora|g o r a
gordon|g o r d 1 n
goren|g o r 1 n
gore|g o r
gorki|g o r c i
gossip|g a s 1 p
got|g a t
goy|g o j
go|g o u
grad|g r e t
graeme|g r e j m
graham|g r e h 1 m
grall|g r o 5
grande|g r a n d e
grand|g r e n t
grange|g r e j n tS
gran|g r e n
gratis|g r a t i s
green|g r i n
gregory|g r e g 1 r i
greve|g r e v e
grey|g r e j
grigory|g r i g o r i
grimaldo|g r i m a 5 d o
gringo|g r i N g o
grinin|gj i r i n i n
grog|g r a k
groot|g r u t
group|g r u p
gruba|g r u b a
grubuna|g u r u b u n a
grumpy|g r a m p i
grundig|g r a n d i k
guangzhou|g w a N dZ o u
guantanamo|g w a n t a n 1 m o
guardian|g a r d i 1 n
guardiola|g v a r d i o l a
gucci|g u tS i
guevara|gj e v a r a
guido|g w i d o
guin|g w i n
gula|gj j u 5 1
gul|g u 5
gump|g a m p
gum|g a m
gunnar|g a n 1 r
guru|g u r u
gustavo|g u s t a v o
gustav|g u s t a f
gutenberg|g u t 1 n b 1 r k
guys|g a j z
guy|g a j
haberle|h a b e r l e
habibi|h a b i b i
habib|h a b i p
hack|h e k
hade|h e j t
hadid|h a d i t
haim|h a j m
hakki|h e c i
halbuki|h a 5 b u c i
halden|h o 5 d 1 n
halde|h a l d e
halen|h aa 5 e n
haley|h e j l i
halide|h e 5 a j t
halinde|h aa l i n d e
haline|h aa l i n e
halla|h e 5 1
haller|h o 5 1 r
hallet|h e l i t
halley|h e l i
hall|h o 5
halo|h e j 5 o u
hama|h a m 1
hamilton|h e m 1 5 t 1 n
hamlet|h e m 5 1 t
handa|h e n d 1
handsome|h e n s 1 m
hannah|h e n 1
hans|h a n s
happy|h e p i
harbin|h a r b i n
harb|h a r p
hard|h a r t
harlem|h a r 5 1 m
harrington|h e r i N k t 1 n
harry|h e r i
harvard|h a r v 1 r t
harvey|h a r v i
hashtag|h e S t e k
hassan|h a s a n
hastanede|h a s t aa n e d e
hatem|h a t e m
have|h e v
hayatım|h a j aa t 1 m
hayatımın|h a j aa t 1 m 1 n
hayden|h e j d 1 n
hayes|h e j z
hazard|h e z 1 r t
hazel|h e j z 1 5
hdp|h ee d ee p ee
header|h e d 1 r
headshot|h e t S a t
health|h e 5 t
heart|h a r t
heer|h i 1 r
hee|h e
hegel|h e g 1 5
heh|h e h
heidegger|h a j d 1 g 1 r
heidi|h e j d i
heimlich|h a j m l i c
helin|h e l i n
hello|h e 5 o u
hell|h e 5
help|h e 5 p
hemingway|h e m i N g w e j
hemmen|h e m 1 n
henrik|h e n r i k
henri|h e n r i
henry|h e n r i
hepburn|h e p b 2 r n
hepp|h e p
herbert|h 2 r b 1 r t
here|h i r
hermann|h 2 r m 1 n
hernandez|h e r n a n d 1 s
hero|h i r o w
hersey|h 2 r s i
hertha|h 2 r t 1
hervé|e r v e
hesse|h e s
heye|h a j
heys|h e j s
hice|h a j s
hill|h i 5
hilton|h i 5 t 1 n
him|h i m
hipster|h i p s t 1 r
hisle|h a j 1 5
hitchcock|h i tS k o k
hitman|h i t m e n
hizasında|h i z aa s 1 n d a
hizmetkarı|h i z m e t k a r 1
hi|h a j
hmmm|h m
hmm|h m
hm|h m
hobbit|h o b i t
hobin|h o b i n
hoffer|h a f 1 r
hoh|h o h
holi|h o l i
hollywood|h a l i w u t
holly|h o l i
holmes|h o w m s
hologram|h a 5 1 g r e m
holt|h o 5 t
home|h o u m
honda|h o n d a
hong|h o N k
honor|o n 1 r
honoré|o n o r e
hoop|h u p
hopf|h o p f
hopp|h o p
horace|h o r 1 s
horatius|h o r a t s i u s
horror|h o r 1 r
hosseini|h o s s e i n i
host|h o u s t
hour|a w 1 r
house|h a u s
houston|h j u s t 1 n
howard|h a u 1 r t
hoşlanmazlar|h o S 5 a n m a z 5 a r
http|e j tS t i t i p i
hua|h u a
hubert|h j u b 1 r t
hud|h a t
hugo|h j u g 1
huh|h a
hulk|h a 5 k
hume|h j u m
hunter|h u n t 1 r
hurşit|h u r S i t
hutchinson|h a tS i n s 1 n
huxley|h a k s l i
hyde|h a j t
hydra|h a j d r 1
hyundai|h a n d e j
hz|h 2 r t z
hımmm|h 11 m
hım|h 1 m
ibanez|i b a n 1 z
ibni|i b n i
ibn|i b 1 n
ice|a j s
icon|a j k 1 n
idiots|i d i 1 t s
idiot|i d i 1 t
idol|a j d 1 5
ido|i d o
iett|ii ee t ee t ee
ifadeye|i f a d e j e
ifadeyi|i f a d e j i
ifadeyle|i f a d e j l e
if|i f
ikea|i c e a
ike|a j c
ilahiler|i l aa h ii l e r
ilana|i 5 a n a
ilan|i 5 a n
ila|i l aa
illuminati|i l u m i n a t i
ill|i 5
imkanı|i m c aa n 1
implant|i m p l e n t
imzaladı|i m z a 5 a d 1
ina|i n 1
inception|i n s e p S 1 n
info|i n f o w
iniesta|i n j e s t a
inkar|i N c aa r
inlet|i n 5 e t
inn|i n
insane|i n s e j n
insightful|i n s a j t f u 5
instagram|i n s t a g r e m
ins|i n s
internet|i n t e r n e t
inter|i n t e r
inter|i n t 2 r
intifada|i n t i f aa d a
invisible|i n v i z 1 b 1 5
ios|a j o s
ipad|a j p e t
iphone|a j f o u n
iq|a j c j u
iran|i r a n
iron|a j r 1 n
islami|i s l aa m ii
islam|i s 5 a m
isla|i s 5 a
isler|a j 5 1 r
islâmın|i s 5 aa m 1 n
ismail|i s m a i l
issah|i s a
iten|i t 1 n
itunes|a j t u n z
ivan|i v a n
ivan|i v a n
jabbar|dZ e b a r
jackie|dZ e c i
jackson|dZ e k s 1 n
jack|dZ e k
jacques|Z a k
james|dZ e j m s
jamie|dZ e j m i
jane|dZ e j n
janssen|dZ e n s 1 n
jan|dZ e n
japan|dZ 1 p e n
jasmin|dZ e z m i n
jason|dZ e j s 1 n
javascript|dZ a v a s k r i p t
jazz|dZ e s
jean|Z a n
jedi|dZ e d i
jefferson|dZ e f 1 r s 1 n
jeffrey|dZ e f r i
jeff|dZ e f
jem|dZ e m
jennie|dZ e n i
jens|j e n s
jerde|dZ 2 r t
jerome|dZ 1 r o w m
jerry|dZ e r i
jesus|dZ i z 1 s
jimmy|dZ i m i
jim|dZ i m
ji|dZ i
joachim|j o a h i m
joao|Z u a u
jobs|dZ a b z
joel|dZ o w 1 5
joe|dZ o u
johannes|j o h a n 1 s
johann|j o h 1 n
johan|j o h a n
johnson|dZ a n s 1 n
johny|dZ o n i
john|dZ o n
joker|dZ o c e r
jolly|dZ o l i
jonas|dZ o n 1 s
jonathan|dZ a n 1 t 1 n
jones|dZ o w n s
jong|dZ o N k
jonsson|j o n s 1 n
jon|dZ a n
jordan|dZ o r d 1 n
jordi|dZ o r d i
jorge|h o r h e
josef|dZ o z 1 f
joseph|dZ o z 1 f
jose|h o z e
jos|dZ o u z
joubert|j u b e r
journal|dZ 2 r n 1 5
joyce|dZ o j s
joy|dZ o j
jr|dZ u n i 1 r
juan|h u a n
judge|dZ a tS
juliet|dZ u l i e t
julio|dZ u l i o
jumping|dZ a m p i N c
jung|j u N k
juniors|dZ u n i 1 r s
junior|dZ y n i 1 r
jupiter|dZ u p i t 1 r
justin|dZ a s t 1 n
just|dZ a s t
juventus|j u v e n t u s
juve|dZ u v
kabbani|k a b a n i
kadlec|k a d l e t s
kafka|k a f k a
kahkahayla|k a h k a h a j 5 a
kahr|k a r
kah|k a h
kai|k a j
kalbim|k a l b i m
kalb|k a l p
kalin|c e l i n
kall|k o 5
kalman|c e 5 m 1 n
kamal|k a m a l
kampta|k a m p t a
kamuoyunun|k a m u o j u n u n
kanan|c e n 1 n
kane|c e j n
kanka|c e n k 1
kanter|c e n t 1 r
karamazov|k a r a m a z o w
karam|k a r a m
karan|k a r a n
kararın|k a r aa r 1 n
kardashian|k a r d a S i a n
karenina|k a r e n i n a
karen|c e r 1 n
karimi|k a r i m i
karim|k a r i m
karin|c e r i n
karla|k a r l a
karl|k a r 5
karr|k a r
kasas|k a s a s
kase|k aa s e
kate|c e j t
katili|k a t i l i
katya|k a t j 1
katy|c e j t i
kays|c e j s
ka|k a
kdv|k aa d ee v ee
kebab|c e b a p
keep|c i p
kellen|c e 5 1 n
keller|c e l 1 r
kelp|c e 5 p
kelsey|c e 5 s i
kenan|c e n a n
kennedy|c e n 1 d i
kente|c e n t e
kenya|c e n j 1
keri|c e r i
kerouac|c e r u a k
ker|c 2 r
kesi|c e s i
keske|c e s c
kess|c e s
kevin|c e v i n
keynote|c i n o u t
key|c i
khaled|h a l e t
khalifa|k 1 l i f 1
khan|k a n
kiev|c i e v
kiki|c i c i
kimm|c i m
kinder|k i n d 1 r
kindle|c i n d 1 5
kind|k a j n t
king|c i N k
kirk|c 2 r k
kismet|c i s m i t
kiss|c i s
kis|c i s
kişner|c i S n e r
kkk|c e j c e j c e j
klass|k 5 a s
klopp|k 5 o p
klu|k 5 u
knight|n a j t
knut|k n u t
kobe|k o u b i
kohen|k o u 1 n
kokan|k o k a n
kolhan|k o 5 h a n
kollar|k a 5 1 r
kongrenin|k o n g r e n i n
kong|k o N k
konrad|k o n r a t
konstantinos|k o n s t a n t i n o s
kon|k o n
koper|k o u p 1 r
kostas|k o s t 1 s
kosta|k o u s t 1
kos|k o s
kovar|k o u v 1 r
kpss|k aa p ee s ee s ee
krala|k r a 5 a
krall|k r o 5
kralı|k 1 r a 5 1
krasnodar|k r a s n o d a r
kremlin|k r e m 5 1 n
kristen|k r i s t e n
kristin|k r i s t i n
kristof|k r i s t o f
krizden|k r i z d e n
krizinden|c r i z i n d e n
krizine|k r i z i n e
krzysztof|k r i s t o f
kuantum|k u a n t u m
kuan|k w a n
kuban|c j u b 1 n
kubrick|c y b r i k
kucher|k u tS 1 r
kulaga|k u 5 a g a
kulpa|k a 5 p a
kuna|k u n a
kundera|k u n d 1 r a
kurd|c 2 r t
kus|k a s
kuyt|k u j t
kuze|c j u s
kwak|k w e k
kym|c i m
küme|c y m e
labyrinth|5 e b 1 r i n t
lacan|5 a k a n
lady|5 e j d i
lag|l e c
lahey|5 a h e j
laikliğin|l a i k l ii n
laik|5 a i c
lakers|5 e j k 1 r z
lakin|l aa c i n
lal|5 a 5
lama|5 a m a
lambası|l a m b a s 1
lam|5 e m
lanet|l aa n e t
lao|5 a o
laptop|l e p t a p
lara|5 a r a
larina|5 a r i n a
larine|5 a r i n i
larry|5 e r i
larsson|5 a r s 1 n
lask|l e s k
lassa|5 a s 1
last|l e s t
las|l a s
latin|l e t i n
lato|l a t o
latte|5 a t e j
laurent|5 o r a n
lavinia|5 a v i n j 1
lavrov|l a v r o v
lays|5 e j z
lay|5 e j
lazer|5 e j z 1 r
lazım|l aa z 1 m
leadership|l i d 1 r S i p
league|l i k
leaks|l i k s
lebron|5 e b r 1 n
led|5 e t
leeds|l i t s
lee|l i
legends|5 e dZ 1 n t s
leicester|l e s t 1 r
leipzig|5 a j p z i k
leman|l e m a n
lem|l e m
lena|l e n a
lennon|l e n 1 n
len|l e n
leonardo|l e o n a r d o
leonard|l e n 1 r t
leon|l i a n
leo|l i o w
les|5 e s
lets|5 e t s
let|l e t
level|5 e v 1 5
levy|l e v i
lev|l e v
lewandowski|l e v a n d o f s c i
lewis|5 u i s
leydi|l e j d i
leyla|l e j 5 a
liars|5 a j 1 r s
libertine|l i b 1 r t i n
libya|l i b j a
lice|5 a j s
lideri|l ii d e r i
liderler|l ii d e r l e r
liege|l i tS
life|5 a j f
light|5 a j t
like|5 a j k
lila|l i 5 a
lili|l i l i
lille|l i l
lil|l i 5
lima|l i m a
lim|l i m
lince|l i n s e
lincoln|l i N k 1 l n
linc|l i N k
lingo|l i N g o w
linke|l i N c e
linz|l i n s
lionel|5 a j 1 n 1 5
lipton|l i p t 1 n
lisa|l i s a
list|l i s t
little|l i t 1 5
liverpool|l i v 1 r p u 5
lives|l i v z
live|5 a j v
liv|l i v
ln|e l ee n
loading|5 o u d i N k
lob|5 a p
locke|5 a k
lock|5 a k
logar|5 o g a r
login|5 o gj i n
lokantasında|5 o k a n t a s 1 n d a
lola|5 o u 5 1
lol|5 o 5
londra|5 o n d r a
lonely|5 o w n l i
longoria|5 o u N g o r i j a
long|5 o N k
look|l u k
loo|5 u
lopes|5 o p e s
lopez|5 o p 1 s
lordum|l o r d u m
lord|5 o r t
lorenzo|l o r e n t s o
lorin|5 o r i n
loris|5 o r i s
loser|5 u z 1 r
lost|5 o s t
los|5 o s
lotte|l o t t e
lot|5 a t
louie|5 u i
louis|l u i s
louvre|5 u v 1 r
love|5 a f
low|5 o u
lo|5 o
ltd|l i m i t i t
lucas|l u k 1 s
luciano|5 u tS a n o
lucky|5 a c i
lucy|l u s i
ludwig|l u d v i k
lugano|l u g a n o
luis|l y i s
luiz|l u i s
lukas|5 u k 1 z
luka|l u k a
luke|l u c
luks|5 a k s
lung|l a N k
luther|5 u t 1 r
lyme|5 a j m
lyon|l i o n
lys|l i s
maas|m a s
mabel|m e j b 1 5
mace|m e j s
machiavelli|m a c i 1 v e l i
mactan|m 1 k t e n
mac|m e k
madame|m e d 1 m
madden|m e d 1 n
madende|m aa d e n d e
madene|m a d e n e
madene|m aa d e n e
made|m e j t
madonna|m a d o n n a
madrid|m a d r i t
magnolia|m e g n o l i j a
magnum|m e gj n 1 m
magus|m e j g 1 s
mahatma|m a h a t m a
mahkum|m a h c u m
mahmud|m a h m u t
mah|m a
mainichi|m a i n i tS i
majid|m 1 dZ i t
makamına|m a k aa m 1 n a
make|m e j c
malcolm|m a 5 k 1 5 m
malcom|m e 5 k 1 m
malek|m a 5 1 k
mali|m a l i
mamma|m a m a
mam|m e m
manager|m e n 1 dZ 1 r
manchester|m e n tS 1 s t 1 r
mancini|m a n tS i n i
manco|m a n tS o
mandela|m a n d e l a
mane|m e j n
manhattan|m e n h e t 1 n
maniatis|m e n i a t i s
manly|m e n l i
manson|m e n s 1 n
mansour|m e n s 1 r
mansur|m a n s u r
manuel|m a n u e l
manu|m a n u
mao|m a u
mapes|m e j p s
maradona|m a r a d o n a
maranki|m a r a N c i
marcelo|m a r tS e 5 o
marcel|m a r s e l
marcos|m a r k o u s
marco|m a r k o
marcus|m a r k 1 s
marc|m a r k
margaret|m a r g 1 r 1 t
marguerite|m a r gj e r i t
mariano|m e r i a n o u
marilyn|m e r 1 5 1 n
mario|m a r i o
markan|m a r k 1 n
markovic|m a r k o v i tS
markus|m a r k 1 s
marla|m a r 5 1
marlboro|m a 5 b o r o
marlen|m a r 5 1 n
marlo|m a r 5 o u
marotta|m 1 r o t a
marques|m a r c e s
marquez|m a r c e s
marquis|m a r c i s
marseille|m a r s e j
marshal|m a r S 1 5
marta|m a r t 1
marvel|m a r v 1 5
mary|m e r i
masaya|m a s a j a
maslow|m a s 5 o u
massachusetts|m e s 1 tS u s 1 t s
mastercard|m a s t 1 r k a r t
mata|m a t a
match|m e tS
mathieu|m a t j 2
mathilda|m e t i 5 d a
matrix|m e j t r i k s
mats|m e t s
matthew|m e t j u
mattis|m a t i s
matt|m e t
mauricio|m a u r i s i o
maurizio|m a u r i t s j o
mauro|m a u r o
mavis|m e j v i s
maxi|m e k s i
max|m e k s
maybe|m e j b i
mayda|m e j d 1
may|m e j
mazo|m a z o u
mbaye|m b a j e
mcgregor|m a k g r e g 1 r
mckinsey|m 1 c i n z i
mc|m i k
md|e m d i
means|m i n s
mean|m i n
medel|m e d 1 5
medical|m e d i k 1 5
medi|m e d i
med|m e t
meets|m i t s
mee|m i
meger|m ee r
mehan|m e j h e n
mehdi|m e h d ii
meksika|m e c s i k a
melissa|m e l i s a
melli|m e l i
mell|m e 5
melo|m e 5 o
memoli|m 1 m o u l i
memorial|m e m o r i 1 5
memo|m e m o w
memuruyum|m ee m u r u j u m
mencken|m e N k 1 n
mendes|m e n d e s
mende|m e n d i
menem|m e n e m
mennan|m e n n a n
menna|m e n a
mensah|m e n s a
mental|m e n t 1 5
mention|m e n S 1 n
mercedes|m e r s e d e s
merc|m 2 r k
meri|m e r i
merkel|m 2 r k 1 5
merker|m e r c e r
merk|m 2 r k
merlin|m 2 r l i n
messi|m e s s i
metallica|m i t e l i k a
mete|m e t e
meyer|m a j 1 r
mhk|m ee h ee k aa
mhp|m ee h ee p ee
mh|e m e j tS
miami|m a j e m i
mia|m i a
michael|m a j k 1 5
michal|m i h a 5
michelangelo|m i c e l a n dZ e 5 o
michel|m i S e l
microsoft|m a j k r o s o f t
mic|m a j c
midem|m ii d e m
miguel|m i gj e l
mikel|m i k 1 5
mike|m a j k
milan|m i l a n
mile|m a j 5
milkshake|m i 5 k S e j k
miller|m i l 1 r
millette|m i l e t
milli|m i l i
milosevic|m i 5 o S 1 v i tS
milos|m i 5 o u s
mina|m i n a
mind|m a j n t
minecraft|m a j n k r e f t
mining|m a j n i N c
minke|m i N c
min|m i n
miranda|m i r e n d a
mirasının|m ii r aa s 1 n 1 n
miroslav|m i r 1 s 5 a v
mirror|m i r 1 r
mirsad|m i r s a t
mission|m i S 1 n
missouri|m i z u r i
miss|m i s
mitroglou|m i t r o g 5 o u
mitsubishi|m i t s u b i S i
mix|m i k s
miyazaki|m i j a z a c i
mize|m a j z
mke|m ee k aa ee
mm|m
mobile|m o u b 1 5
moca|m o k a
mode|m o w t
mod|m o t
mohamed|m o u h a m 1 t
moke|m o w k
moldova|m o 5 d o v a
moliere|m o l j e r
mommy|m a m i
mom|m a m
monaco|m o n a k o
mona|m o n a
mondragon|m o n d r a g o n
monet|m o n e
money|m a n i
monopoly|m o n o p 1 l i
monroe|m 1 n r o u
montaigne|m o n t e n
montana|m a n t e n a
monte|m o n t i
mont|m o n t
moody's|m u d i s
mood|m u t
moore|m u r
moral|m o r a l
mordor|m o r d 1 r
morel|m 1 r e 5
more|m o r
morgan|m o r g 1 n
morgen|m o r g 1 n
moritz|m o r i t s
morning|m o r n i N k
morse|m o r s
moses|m o z 1 s
mossad|m o s a t
mosso|m o s s o
mostar|m o s t a r
most|m o u s t
motherfucker|m a d 1 r f a k 1 r
mothers|m a d 1 r s
mother|m a d 1 r
motive|m o t i f
motto|m o t o
mountain|m a u n t 1 n
mourinho|m o u r i n j o
moussa|m u s a
mozart|m o z a r t
mr|m i s t 1 r
ms|m i s
mtv|e m t i v i
mubarak|m u b a r a k
much|m a tS
muck|m a k
muharram|m u h a r a m
multivitamin|m a l t i v a j t 1 m i n
murad|m u r a t
murakami|m u r a k a m i
murdoch|m 2 r d 1 k
murillo|m u r i l j o
muro|m u r o
murphy|m 2 r f i
murray|m 2 r i
muscle|m a s 1 5
music|m j u z i c
musk|m a s k
mussolini|m u s o l i n i
mustafa|m u s t a f a
mutant|m j u t 1 n t
muzik|m j u z i k
myanmar|m j a n m a r
mystic|m i s t i c
my|m a j
müjgân|m y Z gj a n
münih|m y n i h
müptelası|m y p t e l a s 1
naber|n aa b e r
nabil|n a b i l
nabi|n a b i
nabokov|n a b o k o w
nadal|n a d a l
nah|n a
naim|n a i m
nakamura|n a k a m u r a
nana|n e n 1
nando|n a n d o
nano|n a n o u
naomi|n e j o u m i
napoleon|n a p o l e o n
napoli|n a p o l i
napolyon|n a p o l j 1 n
narcos|n a r k o u s
narda|n a r d a
nasa|n e s a
nash|n e S
nasr|n a s 1 r
nasser|n a s e r
natali|n a t a l i
national|n e S 1 n 1 5
nauert|n a w 1 r t
navas|n a v a s
nays|n e j s
nay|n e j
nazarbayev|n a z a r b a j e f
nba|e n b i e j
nbc|e n b i s i
ndiaye|n i d i a j e
necmettin|n e dZ m e t t i n
neco|n e k o w
need|n i t
nee|n i
neil|n i 5
nein|n a j n
nelson|n e l s 1 n
nemo|n e m o w
neo|n i o
neredeler|n e r e d e l e r
neruda|n e r u d a
nestle|n e s 1 5
nes|n e s
netflix|n e t f l i k s
neto|n e t u
nett|n e t
never|n e v 1 r
neville|n e v i 5
nevin|n e v i n
news|n j u s
newton|n j u t 1 n
new|n y
next|n e k s t
ngo|n ee gj ee oo
niagara|n a j e g a r a
niam|n i a m
nick|n i c
nicolas|n i k 1 5 1 s
nicolo|n i k o 5 o
nietzsche|n i t S e
nie|n i e
nigel|n a j dZ 1 5
nightingale|n a j t i N gj e j 1 5
night|n a j t
nike|n a j c i
nikki|n i c i
nikolayeviç|n i k o 5 a j e v i tS
nikola|n i k o 5 a
nil|n i 5
ninja|n i n dZ a
nirvana|n i r v a n a
nisbet|n i z b 1 t
nizar|n i z a r
noah|n o w a
noam|n o u m
nobel|n o u b e 5
noble|n o u b 1 5
nokia|n o u c i a
nolan|n o u 5 1 n
norman|n o r m 1 n
notebook|n o u t b u k
note|n o u t
notre|n o t r
notte|n o t
novak|n o v a k
now|n a w
ntv|n ee t ee v ee
numan|n j u m 1 n
number|n a m b 1 r
nunnally|n a n 1 l i
nuovo|n u o v o
nu|n u
obama|o b a m a
obezite|o b e z i t e
ocon|o k o n
oden|o d 1 n
odtü|o t t y
odum|o d u m
oecd|o w i s i d i
official|a f i S 1 5
offline|o f 5 a j n
off|o f
ogle|o u g 1 5
ogren|o g r 1 n
ohal|o h a l
ohh|o u
okay|o u c e j
oki|o c i
okun|o k u n
okura|o k u r a
olack|o u 5 1 k
olde|o u 5 t
old|o 5 t
olen|o 5 1 n
oley|o l e j
oliver|o l i v 1 r
olivia|o u l i v i 1
olric|o 5 r i c
olsen|o u 5 s 1 n
olympique|o l i m p i c
omuzundan|o m z u n d a n
on-line|o n 5 a j n
onan|o n a n
once|w a n s
one|w a n
online|o n 5 a j n
only|o w n l i
ooh|uu
oooh|uu
oop|u p
opec|o u p e k
open|o u p 1 n
oral|o r 1 5
ord|o r t
ortega|o r t e j g 1
orwell|o r w e 5
osaka|o s a k 1
oscar|o s k a r
oslo|o s 5 o
ospina|o s p i n a
ost|o u s t
ota|o w t a
othello|o t e 5 o
otto|o t o
our|a u 1 r
outside|a u t s a j t
out|a u t
overrated|o u v 1 r r e j t i t
over|o u v 1 r
owen|o v 1 n
oxford|a k s f 1 r t
ozark|o u z a r k
oz|o s
oğuzhan|o u s h a n
pablo|p a b 5 o
paca|p a k a
pace|p e j s
pacino|p a tS i n o
pais|p e j s
pakistan|p a c i s t a n
palace|p e 5 1 s
palahniuk|p a 5 a h n i u k
palsy|p o 5 z i
pamela|p e m 1 5 1
pans|p e n s
panther|p e n t 1 r
papp|p e p
papua|p a p u a
parada|p a r a d a
paradiso|p a r a d i s o
paraguay|p a r a g w a j
parana|p 1 r a n 1
paranoid|p e r 1 n o j t
parisi|p a r i s i
paris|p a r i s
parlamento|p a r l a m e n t o
parliament|p a r 5 1 m 1 n t
parma|p a r m a
parody|p e r 1 d i
parra|p a r a
partin|p a r t i n
parttime|p a r t t a j m
party|p a r t i
part|p a r t
pascal|p a s k a 5
paste|p e j s t
past|p e s t
patricia|p a t r i S i a
patrick|p e t r i k
patriot|p e j t r i o t
paula|p a u l a
paulo|p a u 5 o
paul|p o l
pavelka|p a v e 5 k a
pavel|p a v 1 5
pavese|p a v e z e
pavey|p e j v i
paz|p a s
pc|p i s i
pdf|p i d i e f
pdr|p ee d ee r ee
pedro|p e d r o
pegasus|p e g 1 s 1 s
pekala|p e c aa l aa
pentagon|p e n t a g o n
pen|p e n
pepsi|p e p s i
pep|p e p
pera|p e r a
pereira|p e r e j r a
perez|p e r e z
perfect|p 1 r f e k t
periscope|p e r i s k o w p
perkins|p 2 r k 1 n z
pero|p e r o
perry|p e r i
persie|p e r s i e
pert|p 2 r t
peru|p e r u
per|p 2 r
pessoa|p e s s o a
peter|p i t 1 r
petit|p 2 t i
petra|p e t r a
petro|p e t r o
petr|p e t 1 r
philadelphia|f i 5 1 d e 5 f i 1
philippe|f i l i p
philips|f i l i p s
philip|f i l i p
phillip|f i l i p
phil|f i 5
phoenix|f i n i k s
photoshop|f o t o S o p
photos|f o u t o u z
photo|f o t o
pianist|p i e n 1 s t
piano|p i e n o u
pia|p i a
picasso|p i k a s o
pic|p i k
piero|p j e r o
pierre|p j e r
pilates|p i 5 a t i s
pinochet|p i n o S e
pinokyo|p i n o c j o
pinto|p i n t o
pique|p i c
pirelli|p i r e l i
pires|p a j r s
piro|p i r o u
pitt|p i t
pit|p i t
pivot|p i v 1 t
pişmanız|p i S m aa n 1 z
pkk|p ee k ee k ee
planlarının|p l a n 5 a r n 1 n
planları|p i l a n 5 a r 1
planlıyor|p 1 l a n 5 1 j o r
plan|p i l a n
planı|p i l a n 1
plate|p 5 e j t
platformda|p l a t f o r m d a
platform|p 5 e t f o r m
plath|p 5 a t
platon|p l a t o n
playlist|p 5 e j l i s t
playoff|p 5 e j o f
plaza|p 5 a z a
please|p l i s
plese|p l i z
plum|p 5 a m
plus|p 5 a s
podcast|p o t k a s t
podolski|p o d o 5 s c i
poe|p o u
poh|p o h
point|p o j n t
pokemon|p o c e m o n
polar|p o w 5 1 r
polen|p o 5 1 n
political|p o l i t i k 1 5
pollyanna|p o l i e n a
polly|p o l i
polonya|p o 5 o n j a
pompeo|p o u m p i o u
popov|p o p o v
postino|p o s t i n o
postmodern|p o s t m o d 1 r n
powell|p a u 1 5
power|p a w 1 r
premier|p r e m j e r
premium|p r i m i u m
prensa|p r e n s a
prestige|p r e s t i S
pretty|p r i t i
prime|p r a j m
princeton|p r i n s t 1 n
prison|p r i z 1 n
profile|p r o u f a j 5
promo|p r o m o
protector|p r a t e k t 1 r
proust|p r u s t
province|p r o v a n s
prozac|p r o u z 1 k
pro|p r o u
pulp|p a 5 p
putin|p u t i n
puzzle|p a z 1 5
pvc|p i v i s i
pyd|p ee j ee d ee
quantum|k w a n t 1 m
quaresma|k u a r e s m a
queen|k w i n
quigley|k w i g l i
q|c j u
raad|r aa t
rabbani|r a b a n i
rabbin|r a b b i n
rabb|r e p
rachel|r e j tS 1 5
racing|r e j s i N c
radyonun|r a d j o n u n
rad|r e t
rafael|r a f a e l
rafi|r e f i
ragmen|r e g m 1 n
rah|r a
ralf|r a 5 f
ralph|r e 5 f
ramadan|r a m a d a n
rama|r a m a
ramos|r a m o s
ramses|r e m s i z
ramsey|r e m z i
rana|r aa n aa
random|r e n d 1 m
rand|r e n t
rangers|r e j n dZ 1 r s
range|r e j n tS
rania|r a n i a
ranta|r e n t 1
ran|r e n
rape|r e j p
rapper|r e p 1 r
rapunzel|r a p u t s 1 5
ratings|r e j t i N g z
raul|r a u l
raz|r e s
rca|a r s i e j
really|r i l i
real|r i a 5
records|r e k 1 r t s
record|r i k o r t
redd|r e t
redemption|r i d e m p S 1 n
redi|r e d i
red|r e t
reeves|r i v s
ref|r e f
regular|r e gj j 1 5 1 r
reich|r a j h
reina|r e i n 1
reise|r i s
reiss|r a j s
relax|r i 5 e k s
rembrandt|r e m b r a n t
remember|r i m e m b 1 r
remy|r e m i
rem|r e m
renato|r i n a t o
renault|r e n o
rene|r e n e
renkte|r e N c t e
replay|r i p l e j
report|r i p o r t
rep|r e p
reschke|r e S k 1
reset|r i s e t
respect|r i s p e k t
reuters|r o j t 1 r s
reyes|r e j e s
reza|r e z a
rhapsody|r e p s 1 d i
ria|r i a
ricardo|r i k a r d o
rice|r a j s
richard|r i tS 1 r t
ricky|r i c i
rico|r i k o u
riera|r i j e r a
right|r a j t
rihanna|r i h a n a
rim|r i m
ringo|r i N g o u
rio|r i o
ripple|r i p 1 5
rip|r i p
rising|r a j z i N k
riske|r i s k
ritz|r i t s
riva|r i v a
river|r i v 1 r
riyad|r i j a t
rna|a r e n e j
road|r o u t
robben|r o b 1 n
robbins|r a b i n z
roberto|r o b e r t o
robert|r o b e r t
rober|r o b e r
robins|r o b i n s
robin|r o b i n
rocks|r a k s
rocky|r o c i
rock|r a k
rodrigo|r 1 d r i g o
rodrigues|r a d r i gj i s
rodriguez|r a d r i g 1 z
roger|r a dZ 1 r
rohn|r o n
roland|r o 5 1 n t
rolex|r o l e k s
role|r o w 5
roller|r o w 5 1 r
rolling|r o w l i N k
rolls|r o 5 s
roma|r o m a
romeo|r o m e o
ronaldo|r o n a 5 d o
ronald|r a n 1 5 t
rooney|r u n i
roosevelt|r u z v e l t
rosa|r o z a
rose|r o u z
ross|r a s
rotman|r a t m 1 n
rotterdam|r o t 1 r d e m
rousseau|r u s o
rover|r o u v 1 r
royal|r o j 1 5
rte|a r t i i
ruffles|r a f 1 5 s
ruiz|r u i z
rush|r a S
russell|r a s 1 5
ruth|r u t
ryan|r a j 1 n
rüzgâra|r y z gj a r a
rüzgârın|r y z gj a r 1 n
saad|z a t
sabir|s a b i r
sadakati|s a d a k a t i
saddam|s a d d 1 m
sado|s e j d o w
sad|s e t
saga|s a g a
sago|s e j g o w
sag|s e k
sahibim|s aa h i b i m
sahipler|s a h i p l e r
sahipti|s a h i p t i
said|s e t
sakata|s a k a t a
salah|s a l a h
salonuna|s a 5 o n u n a
samet|s e m i t
sami|s e m i
samsung|s e m s 1 N k
samuel|s e m y 1 5
sanaa|s a n a
sanada|s a n a d a
sandalyede|s a n d a l j e d e
sanda|s e n d 1
sandin|s e n d i n
sane|s e j n
sansa|s a n s a
sans|s a n s
saran|s a r a n
sarin|s a r i n
sarkar|s a r k a r
sars|s a r z
sarti|s a r t i
sartre|s a r t 1 r
sar|s a r
sas|s e s
satan|s a t a n
satin|s e t i n
savas|s a v a s
scotty|s k o t i
scouting|s k a u t i N k
scout|s k a u t
screenshot|s k r i n S a t
seat|s i t
sea|s i
sebastian|s 1 b e s t j 1 n
sec|s e k
seen|s i n
seko|s e k o u
sela|s e 5 1
selda|s e l d a
selden|s e 5 d 1 n
selena|s e l i n a
selfie|s e 5 f i
selfi|s e l f i
selin|s e l i n
seller|s e l 1 r
selma|s e l m a
senn|s e n
sensei|s e n s e j
sense|s e n s
server|s 2 r v 1 r
sese|s e s e
sesler|s e s 5 1 r
sevabına|s e v aa b 1 n a
sever|s e v e r
seve|s e v e
sevilla|s e v i l j a
sevin|s e v i n
sew|s o u
seyi|s e j i
seyler|s e j 5 1 r
sgk|s ee gj ee k aa
shakespeare|S e j k s p i r
shank|S e N k
sherlock|S e r 5 1 k
shipper|S i p 1 r
ship|S i p
shop|S o p
showa|S o w a
show|S o u
sh|S
side|s a j t
sie|z i
sign|s a j n
sig|s i c
siler|s a j 5 1 r
silk|s i 5 k
sims|s i m z
siner|s a j n 1 r
single|s i N g 1 5
siri|s i r i
sirri|s i r i
sir|s 2 r
sisler|s i s 5 1 r
sister|s i s t 1 r
skill|s c i 5
skim|s c i m
skin|s c i n
skip|s c i p
skora|s k o r a
skype|s k a j p
slam|s 5 e m
smile|s m a j 1 5
smith|s i m i t
sms|e s e m e s
snapchat|s n e p tS e t
snap|s n e p
snickers|s n i c i r s
snow|s n o w
soft|s a f t
sok|s o k
solan|s o w 5 1 n
solar|s o 5 1 r
soldan|s o 5 d a n
solum|s o 5 u m
somali|s o m a l i
song|s o N k
sonner|s o n 1 r
sonn|s a n
sonum|s o n u m
soon|s u n
sope|s o u p
sorry|s o r i
sor|s o r
sosa|s o w s a
souza|s u z 1
sow|s a u
so|s o w
space|s p e j s
spam|s p e m
spas|s p a s
spin|s p i n
spoiler|s p o j 5 1 r
sports|s p o r t s
sport|s p o r t
spotify|s p o t 1 f a j
sprint|s i p r i n t
squat|s k w a t
ss|e s e s
stabile|s t e j b i 5
stalk|s t o k
standard|s t e n d 1 r t
stapler|s t e j p 5 1 r
starbucks|s t a r b 1 k s
stark|s t a r k
station|s t e j S 1 n
stefan|s t e f 1 n
stella|s t e 5 1
steps|s t e p s
steve|s t i v
stockholm|s t o k h o 5 m
stories|s t o r i s
story|s t o r i
stream|s t r i m
studies|s t a d i s
style|s t a j l
subliminal|s a b l i m i n 1 5
suc|s a k
suleyman|s u l i m 1 n
suni|s u n i
sunset|s a n s e t
suns|s a n s
sunup|s a n 1 p
superman|s u p 1 r m 1 n
super|s u p e r
survivor|s 2 r v a j v 1 r
susan|s y z 1 n
sushi|s u S i
suss|s a s
swap|s w a p
sweat|s w e t
sylvie|s i l v i
syn|s i n
sürprizlerle|s y r p r i z l e r l e
t-shirt|t i S 2 r t
tabii|t a b i ii
taciri|t a dZ i r i
tac|t i e j s i
tad|t e t
tae|t e j
tag|t e k
tahir|t aa h i r
tai|t a j
taj|t a S
talat|t a 5 a t
talented|t e 5 1 n t i t
taliban|t e l i b e n
talisca|t a l i s k a
tamamiyle|t a m a m i j l e
tama|t a m a
tamm|t e m
tanesi|t aa n e s i
tani|t a n i
tansu|t a n s u
tanya|t a n j a
tara|t e r a
tarsus|t a r s u s
tartar|t a r t a r
tarzan|t a r z e n
tasman|t e s m 1 n
tatum|t e j t 1 m
taylor|t e j 5 1 r
team|t i m
teaser|t i z 1 r
tea|t i
tedesco|t 1 d e s k o u
ted|t e t
teen|t i n
tee|t i
telegram|t e l e g r e m
telekom|t e l e k o m
tele|t e l e
telles|t e l l e s
tense|t e n s
teo|t e o
terry|t e r i
terse|t 2 r s
tesla|t e s 5 a
tess|t e s
tevfik|t ee v f i c
texas|t e k s 1 s
tff|t ee f ee f ee
thanks|t e N k s
thank|t e N k
that|d e t
theodore|t i 1 d o r
theodor|t i 1 d 1 r
theo|t i o u
there|d e r
the|d e
thierry|t i e r i
this|d i s
thomas|t o m 1 s
thompson|t a m p s 1 n
thoreau|t o r o
thor|t o r
three|t r i
thug|t a k
thy|t ee h ee j ee
tianjin|t i e n dZ i n
tic|t i c
tiki|t i c i
timeline|t a j m 5 a j n
times|t a j m s
timur|t i m u r
tinder|t i n d 1 r
tipler|t a j p 5 1 r
tis|t i s
titanic|t a j t e n i k
tlc|t i e 5 s i
tobe|t o u p
together|t u gj e d 1 r
tolstoy|t o 5 s t o j
tomorrow|t u m o r o w
tom|t a m
toni|t o u n i
tonya|t o n j a
tony|t o u n i
too|t u
topel|t o p 1 5
topic|t o p i c
torino|t o r i n o u
torrent|t o r 1 n t
tottenham|t o t 1 n h 1 m
touch|t a tS
toulouse|t u 5 u z
toward|t 1 w o r t
toyota|t o j o t a
to|t u
trailer|t r e j 5 1 r
trak|t r e k
tramp|t r e m p
transformers|t r e n s f o r m 1 r z
translate|t r e n z l e j t
travel|t r e v 1 5
tree|t r i
trende|t 1 r e n d e
trend|t r e n t
tribe|t r a j p
trick|t r i c
trip|t r i p
troll|t r o 5
true|t r u
truman|t u r u m a n
trump|t r a m p
trust|t r a s t
truva|t u r u w a
tse|t s e
tsk|t ee s ee k aa
tsunami|t u s u n a m i
ts|t i e s
tudor|t u d 1 r
tune|t y n
tupac|t u p a k
turban|t 2 r b 1 n
turchi|t u r c i
turgut|t u r g u t
turkey|t 2 r c i
turkish|t 2 r c i S
turk|t 2 r k
turk|t y r k
tv|t i v i
twain|t v e j n
tweet|t v i t
twice|t w a j s
twist|t w i s t
twite|t w a j t
twitter|t v i t 1 r
twitter|t w i t 1 r
twix|t v i k s
two|t u
tyler|t a j 5 1 r
typo|t a j p o w
tyranny|t i r 1 n i
tyson|t a j s 1 n
tzu|t u z u
tıme|t aa j m
tırmandı|t 1 r m a n d 1
uber|u b 1 r
ubuntu|u b u t u
uefa|u e f a
ufo|u f o
uganda|j u gj e n d a
uh|a
ukrayna|u k r a j n a
ula|u 5 a
ultra|u l t r a
umberto|u m b e r t o
underrated|a n d 1 r r e j t 1 t
understand|a n d 1 r s t e n t
undertaken|a n d 1 r t e j c 1 n
under|a n d 1 r
united|j u n a j t i t
university|j u n 1 v 2 r s 1 t i
uni|j u n i
unknown|a n n o u n
update|a p d e j t
upload|a p 5 o w t
urey|j 2 r i
ursula|2 r s 1 5 1
uruguay|u r u g w a j
uy|u j
vahid|v a h i t
vala|v a 5 a
valencia|v a l e n s i a
valery|v e 5 1 r i
valla|v e 5 1
valverde|v a 5 v e r d e
vamos|v a m o u s
vampire|v e m p a j r
vanessa|v 1 n e s 1
vanilla|v a n i 5 a
varela|v a r e 5 1
varin|v a r i n
vasconcelos|v a s k o u n s e j 5 o u z
vecd|v e tS t
veer|v i r
vee|v i
vegan|v e g 1 n
vegas|v e j g 1 s
vega|v e j g 1
vela|v e 5 a
vendetta|v e n d e t a
venezia|v e n e z i a
venezuela|v e n e z u e 5 a
ventures|v e n tS 1 r z
vera|v e r 1
verda|v e r d a
verde|v 2 r d i
verdin|v e r d i n
verdon|v e r d o n
verene|v e r i n
versace|v e r s a tS e
verse|v 2 r s
very|v e r i
vesely|v i z l i
vet|v e t
vey|v e j
vian|v j a n
via|v i a
vice|v a j s
victoria|v i k t o r i 1
victor|v i k t 1 r
vidal|v i d a l
vietnam|v i j e t n a m
vigo|v i g o
viktor|v i k t 1 r
villarreal|v i 5 a r e a l
villa|v i l l a
vincent|v i n s 1 n t
vinci|v i n s i
vine|v a j n
vip|v i a j p i
viral|v a j r 1 5
virginia|v i r dZ i n i j a
visitor|v i z i t 1 r
vista|v i s t 1
vitoria|v i t o r i a
vives|v i v e s
vladimir|v 5 a d i m i r
vodafone|v o d a f o u n
vodka|v o t k a
voice|v o j s
voltaire|v o l t e r
volvo|v o u 5 v o u
vol|v o 5
von|v o n
vow|v a u
vs|v i e s
vücuduna|v y dZ u d u n a
waffle|w a f 1 5
wagner|v a g n 1 r
waikiki|w a j c i c i
waiting|w e j t i N k
walcott|w o 5 k a t
waldo|w a 5 d o
wallace|w o 5 1 s
walla|v o 5 a
wallpaper|w o 5 p e j p 1 r
wall|w o 5
walter|w o 5 t 1 r
walt|w o 5 t
wanamaker|w a n 1 m e j k 1 r
wan|w a n
warcraft|w o r k r a f t
warhol|w o r h 1 5
warren|w o r 1 n
wars|w o r z
war|w o r
washington|v a S 1 N k t 1 n
was|w a z
watford|w o t f 1 r t
wat|w o t
waverly|v e j v 1 r l i
way|w e j
webster|w e p s t 1 r
web|v e p
weekend|v i c e n t
weil|w a j 5
welch|w e 5 tS
welcome|v e 5 k 1 m
wells|w e 5 s
wenger|v e N g 1 r
werder|w 2 r d 1 r
werner|v e r n e r
werther|v e r d 1 r
wesley|v e s l i
west|v e s t
we|w i
whatsapp|v a t s a p
what|w a t
when|w e n
white|w a j t
who|h u
why|w a j
wi-fi|w a j f a j
wifi|v a j f a j
wikipedia|w i c i p i d i 1
wilde|v a j 5 t
wild|w a j 5 t
wilfred|v i 5 f r i t
wilfried|w i 5 f r i t
wilhelm|w i l h e l m
willem|w i 5 1 m
williams|w i l j 1 m z
william|v i l j i m
willis|v i l i s
will|v i 5
wilma|v i 5 m 1
wil|w i 5
windows|w i n d o u z
winfrey|w i n f r i
winged|w i N k t
wings|w i N c s
winner|v i n 1 r
winston|w i n s t 1 n
win|w i n
wish|w i S
with|w i t
wiz|w i z
wolfgang|v o l v g a n k
wolf|w u 5 f
woman|w u m 1 n
wonderland|w a n d 1 r l e n t
won|w a n
woody|w u d i
wood|w u t
woolf|w u 5 f
worked|w 2 r k t
work|w 2 r k
worldwide|w 2 r 5 d w a j t
world|w 2 r 5 t
wow|w a u
wo|w o u
write|r a j t
wrong|r o N k
xbox|e k s b a k s
yabani|j a b a n i
yahoo|j a h u
yahya|j a j a
yakov|j a k o w
yanda|j a n d a
yandex|j a n d e k s
yang|j e N k
yapp|j e p
yap|j a p
yard|j a r t
yarn|j a r n
yasir|j a s i r
yasmin|j a s m i n
yau|j a u
yeah|j e a
year|j i r
yea|j e j
yee|j i
yellow|j e 5 o u
yesen|j e s e n
yes|j e s
yet|j e t
ygs|j ee gj ee s ee
yilin|j i l i n
yim|j i m
yin|j i n
yip|j i p
yi|j i
yoda|j o w d a
yoh|j o h
yon|j o n
yoo|j o
york|j o r k
younes|j u n 1 s
young|j a N k
your|j o r
youssef|j u s 1 f
youtube|j u t u p
you|j u
ypg|j e p e g e
yuk|j a k
yum|j a m
yurek|j u r e c
yuri|j u r i
yury|j u r i
yuval|j u v 1 5
yu|j u
zagreb|z a g r e p
zalimi|z a l i m i
zamanın|z a m aa n 1 n
zamanını|z a m aa n 1 n 1
zara|z a r a
zel|Z e 5
zero|z i r o u
zeus|z u s
zeyna|z e j n a
zeyno|z e j n o
ze|z e
zico|z i k o w
zidane|z i d a n
zile|z i l e
ziller|z i 5 1 r
zinedine|z i n e d i n
ziyad|z i e t
ziyarete|z i j aa r e t e
zi|z i
zola|z o l a
zoom|z u m
zorro|z o r o u
zuckerberg|z a k 1 r b 2 r k
zuzu|z u z u
zweig|z v a j k
zygmunt|z i g m u n t
zywicki|z i w i c i
zürich|t s y r i h
çapayev|tS a p a j e v
çbm|tS e b e m e
çepmın|tS e p m 1 n
çevremde|tS e v r e m d e
çiftliklerdeki|tS i f t l i c l e r d e c i
ömer|2 m e r
ötv|2 t ee v ee
öyk|2 j e k a
öys|2 j e s e
üds|y d e s e
ıan|a j 1 n
ıchabod|i h a b o t
ıdaho|a j d a h o
ıda|i d a
ıkby|i c e b e j e
ıko|a j k o
ıleana|1 l e a n a
ıllich|i l j i tS
ıllidge|i l i tS
ımf|i j e m e f
ımogen|i m o gj e n
ındependent|i n d i p e n d 1 n t
ındustria|i n d a s t r i a
ınglis|i N g l i s
ınquirer|i N k w a j 1 r 1 r
ınternational|i n t 1 r n e S 1 n 1 5
ıntransigeant|i n t r a n s i dZ 1 n t
ınvincible|i n v i n s i b 1 5
ıorek|j o r e c
ıphiginia|i p h i gj i n i a
ıridal|i r i d a 5
ırmgard|i r m g a r t
ırnerio|i r n e r i o
ısaac|a j z e k
ısabel|i s a b e l
ısak|1 s a k
ısseth|1 s s e t h
ıthaca|i t a k a
ıvanovna|i v a n o v n a
ıvy|a j v i
ıxia|i k s i a
ışid|1 S i t
şakir|S aa c i r
şampiyonuyla|S a m p j o n u j l a
şeyy|S e j
şibumi|S i b u m i
şinigami|S i n i g a m i
